6  6  0.8  0.1  -15.0  0.5  
F:   F:   F:   F:   F:   F:   
F:   _:   _:   _:   _:   F:   
F:   _:   _:   _:   _:   F:   
F:   _:   _:   B:10 _:   F:   
F:   S:   _:   F:   G:   F:   
F:   F:   F:   F:   F:   F:   
