6  6  0.8  0.1  -1.0  0.99  
F:   F:   F:   F:    F:    F:   
F:   _:   _:   _:    _:    F:   
F:   _:   _:   _:    _:    F:   
F:   _:   _:   B:-20 _:    F:   
F:   S:   _:   F:    G:100 F:   
F:   F:   F:   F:    F:    F:   
