6  5  0.8  0.1  -0.04  1  
F:   F:   F:   F:   F:   F:   
F:   _:   _:   _:   G:1  F:   
F:   _:   F:   _:   G:-1 F:   
F:   S:   _:   _:   _:   F:   
F:   F:   F:   F:   F:   F:   
